###################
#S.......#........#
#.####.#...#.####.#
#.####...#...####.#
#.####.#.#.#.####.#
#.####.#.#.#.####.#
#........#........#
#.####.#...#.####.#
#.####.#.#.#.####.#
#.####...#...####.#
#.####.#.#.#.####.#
#........#........#
#.####.#...#.####.#
#.####...#...####.#
#.####.#.#.#.####.#
#.####.#.#.#.####.#
#........#........#
#.####.#...#.####.#
#.####...#...####.#
#.####.#.#.#.####.#
#.####.#.#.#.####.#
#........#........#
###################
